C 23,0,23
F 255,255,0

EA media/textures/east.xpm
WE media/textures/west.xpm
SO media/textures/south.xpm
NO media/textures/north.xpm




        11111111111111111111111
11111111100000000000001
11111111100000000000001
10000011111110100000001
10000000000000100111101
100001110000000001  101
100001110000000001  101
1000N0000000000001  1001
100000000000000001  10001
111111111111111111  11111
