C 210,0,255
F 255,0,255

EA media/textures/east.xpm
WE media/textures/west.xpm
SO media/textures/south.xpm
NO media/textures/north.xpm





1111111111111111111111111
11111 11 1110101 10111101
11111 11 1111111 11111111
11111 11 11N1111 11111111
11111 11 1111111 11111111
11111 11 1111111 11111111
11111111 1111111 1111111111
